NO ./textures/wall_north.xpm
SO ./textures/wall_south.xpm
WE ./textures/wall_west.xpm
EA ./textures/wall_east.xpm
F ./textures/floor.xpm
C ./textures/ceiling.xpm

111111111111111111111111
1PP000000000000000000PP1
1P00000000000000000000P1
100000000000000000000001
10000011111000014131000111111111
1000001BLB1000030B0400000L000001
1000001BLB100001BPB100011100L011
1000001BLB1000040B030001 100011
100000113110000131410001 10L01
10000000000000000000001  110011
10000000000000000000001   11L01
10000000000000000000001    10011
10000000000000000000001    11001
10000000000000000000001     1L01 
1P000000000000000000001    11001
1PP00000000000000000011   110L01
111111111000000000111111111L0011
100000001000000000100L030L00011
100L011B1000000000000001000011
10010000100000000000000100011
1001111110000000001111111111
10040LL030000000000000P1
11111111100N000000000PP1
111111111111111111111111
