NO ./textures/wall_north.xpm
SO ./textures/wall_south.xpm
WE ./textures/wall_west.xpm
EA ./textures/wall_east.xpm
F ./textures/floor.xpm
C ./textures/ceiling.xpm

111111111111111111111111
100000000000000000000001
100000000000000000000001
100000000000000000000001
100000111110000101010001
100000100010000000000001
100000100010000100010001
100000100010000000000001
100000110110000101010001
10000000000000000000BB01
10000000000000000P000001
1000000000000000B0000001
100000000000000000000001
100000000000000000000001
100000000000000000000001
101000000000000000000001
111111111000000000000001
110100001000000000000001
110000101000000000000001
110100001000000000000001
110111111000000000000001
110000000000000000000001
11111111100N000000000001
111111111111111111111111
