NO ./textures/wall_north.xpm
SO ./textures/wall_south.xpm
WE ./textures/wall_west.xpm
EA ./textures/wall_east.xpm
F ./textures/floor.xpm
C ./textures/ceiling.xpm

111111111111111111111111
1PP000000000000000000PP1
1P00000000000000000000P1
100000000000000000000001
10000011311000014131000111111111
1000001BLB1000030B0400000L000001
1000001BLB100001BPB100011100L011
1000001BLB1000040B030001 100011
100000111110000131410001 10L1
10000000000000000000001  110011
11311111100000000000001   11L01
1000L00B100000000000001    10011
1111110L1000000B0000001    11001
1B00L00B10000B0B0000001     1L01
1L011111100000000G00001    11001
1B00L0001000G0000000011   110L01
111111131000000000000011111L0011
100000001000B0P000000L030L00011
100L011B100000B000000001000011
100100001000000000000B0100011
100111111B000000000000011111
10040LL030000000000000P1
11111111100N131000000PP1
111111111111111111111111
